000000000000000-
000111111111111-
000100000000000-
000111111111000-
000000000001000-
001111111111000-
001000000000000-
001000000000000